###############################
#      ** *    *   *  * * *   #
# # # #*# # #*#*# # # #*#*#*# #
#   *  1  ***  *      *   * * #
# # # # # #p# # #*#*# # # # #*#
#            **  *  *         #
# # # # # # # # # #*# #*# # # #
#*  x   1  *  *      *        #
# # # # #*# # # #*#*# # # # # #
#*    *y  *       *           #
# #*# # # # # # #*# # # # # # #
#           *   *  *          #
###############################