###############################
#    ** **    *   4           #
# # # #*# # # # # # # # # # # #
#*     ** * *  *   * ** 3 *   #
# # # # # #*# # # # # # #*# # #
#*   *x*    *** * p **        #
# # # # # # # # # # # # # #*# #
#    *     *        *    **  3#
# #y# # #*#*#*#*# # #1# # #*# #
#        *   * *    *   *     #
#*# # # # # # # # # # #*# # #*#
# *    * ** 4  ** ***     3   #
###############################