###############################
#      ** *    *   *  * * *   #
# # # #*# # #*#*# # # #*#*#*# #
#   *     ***  *  2   *   * * #
# # # # # #p# # #*#*# # # # #*#
#            **  *  *         #
# # # # # # # # # #*# #*# # # #
#*  z   1  *  *      *    1   #
# # # # #*# # # #*#*# # # # # #
#*    *z  *   2   *      1    #
# #*# # # # # # #*# # # # # # #
#           *   *  *   2      #
###############################