###############################
#      ** *    *   *  * * *   #
# # # #*# # #*#*# # # #*#*#*# #
#   *     ***  *  2   *   * * #
# # # # # #p# # #*#*# # # # #*#
#            **  *  *         #
# # # # # # # # # #*# #*# # # #
#*  x   1  *  *      *    1   #
# # # # #*# # # #*#*# # # # # #
#*    *y  *   2   *      1    #
# #*# # # # # # #*# # # # # # #
#           *   *  *   2      #
###############################