###############################
#  * *2       *  ** * *      *#
# # # # #*# # #*# # # # # #*# #
#    * * *** **      *    **  #
# #*# # # # #1# #y#1# # # # #*#
#          *     **      *  **#
# # #*# # # # # #*#*#*#*# # # #
#   x        *   * *p* *      #
# # # # #*# # # # # # #*# #*# #
#   ****         *3           #
# # # # # # # # # #*# # # # #*#
#  ** *   *    4              #
###############################