###############################
#      ** *    *   *  * * *   #
# # # #*# # #*#*# # # #*#*#*# #
#   *  1  ***  *      *   * * #
# # # # # #p# # #*#*# # # # #*#
#            **  *  *         #
# # # # # # # # # #*# #*# # # #
#*  *   1  *  *      *        #
# # # # #*# # # #*#*# # # # # #
#*    **  *       *           #
# #*# # # # # # #*# # # # # # #
#           *   *  *          #
###############################