###############################
#      ** *    *   *  * * *   #
# # # #*# # #*#*# # # #*#*#*# #
#   *     ***  *  3   *   * * #
# # # # # #p# # #*#*# # # # #*#
#            z*  *  *    4    #
# # # # # # # # # #*# #*# # # #
#*  y      *  *      *        #
# # # # #*# # # #*#*# # # # # #
#*    **  *  3    *   4       #
# #*# # # # # # #*# # # # # # #
#           *   *  *   3      #
###############################